This Document Describes the variables generated by the R script run_analysis.R that calculates the mean of different measurements calculated based on the Samsung S II Sensor Data for different specified physical activities and the selected subjects who performed those activities.

1. ActivityName = Describes one of the following activities - WALKING, WALKING_UPSTAIRS, WALKING_DOWNSTAIRS, SITTING, STANDING, LAYING
2. Subject = Identifies the subject who perfomed the activities
3. tBodyAcc-mean-X = Mean of time domain body acceleration signal along X Coordinate for a particular Activity and Subject
4. tBodyAcc-mean-Y = Mean of time domain body acceleration signal along Y Coordinate for a particular Activity and Subject
5. tBodyAcc-mean-Z = Mean of time domain body acceleration signal along Z Coordinate for a particular Activity and Subject
6. tGravityAcc-mean-X = Mean of time domain gravity acceleration signal along X Coordinate for a particular Activity and Subject
7. tGravityAcc-mean-Y = Mean of time domain gravity acceleration signal along Y Coordinate for a particular Activity and Subject
8. tGravityAcc-mean-Z = Mean of time domain gravity acceleration signal along Z Coordinate for a particular Activity and Subject
9. tBodyAccJerk-mean-X = Mean of time domain body acceleration jerk signal along X Coordinate for a particular Activity and Subject
10. tBodyAccJerk-mean-Y = Mean of time domain body acceleration jerk signal along Y Coordinate for a particular Activity and Subject
11. tBodyAccJerk-mean-Z = Mean of time domain body acceleration jerk signal along Z Coordinate for a particular Activity and Subject
12. tBodyGyro-mean-X = Mean of time domain body angular velocity signal along X Coordinate for a particular Activity and Subject
13. tBodyGyro-mean-Y = Mean of time domain body angular velocity signal along Y Coordinate for a particular Activity and Subject
14. tBodyGyro-mean-Z = Mean of time domain body angular velocity signal along Z Coordinate for a particular Activity and Subject
15. tBodyGyroJerk-mean-X = Mean of time domain body angular velocity jerk signal along X Coordinate for a particular Activity and Subject
16. tBodyGyroJerk-mean-Y = Mean of time domain body angular velocity jerk signal along Y Coordinate for a particular Activity and Subject
17. tBodyGyroJerk-mean-Z = Mean of time domain body angular velocity jerk signal along Z Coordinate for a particular Activity and Subject
18. tBodyAccMag-mean = Mean of time domain Euclidean norm body acceleration signal for a particular Activity and Subject
19. tGravityAccMag-mean = Mean of time domain Euclidean norm gravity acceleration signal for a particular Activity and Subject
20. tBodyAccJerkMag-mean = Mean of time domain Euclidean norm body acceleration jerk signal for a particular Activity and Subject
21. tBodyGyroMag-mean = Mean of time domain Euclidean norm body angular velocity signal for a particular Activity and Subject
22. tBodyGyroJerkMag-mean = Mean of time domain Euclidean norm body angular velocity jerk signal for a particular Activity and Subject
23. fBodyAcc-mean-X = Mean of frequency domain body acceleration signal along X Coordinate for a particular Activity and Subject
24. fBodyAcc-mean-Y = Mean of frequency domain body acceleration signal along Y Coordinate for a particular Activity and Subject
25. fBodyAcc-mean-Z = Mean of frequency domain body acceleration signal along Z Coordinate for a particular Activity and Subject
26. fBodyAccJerk-mean-X = Mean of frequency domain body acceleration jerk signal along X Coordinate for a particular Activity and Subject
27. fBodyAccJerk-mean-Y = Mean of frequency domain body acceleration jerk signal along Y Coordinate for a particular Activity and Subjec
28. fBodyAccJerk-mean-Z = Mean of frequency domain body acceleration jerk signal along Z Coordinate for a particular Activity and Subjec
29. fBodyGyro-mean-X = Mean of frequency domain body angular velocity signal along X Coordinate for a particular Activity and Subject
30. fBodyGyro-mean-Y = Mean of frequency domain body angular velocity signal along Y Coordinate for a particular Activity and Subject
31. fBodyGyro-mean-Z = Mean of frequency domain body angular velocity signal along Z Coordinate for a particular Activity and Subject
32. fBodyAccMag-mean = Mean of frequency domain Euclidean norm body acceleration signal for a particular Activity and Subject
33. fBodyBodyAccJerkMag-mean = Mean of frequency domain Euclidean norm body acceleration signal for a particular Activity and Subject
34. fBodyBodyGyroMag-mean = Mean of frequency domain Euclidean norm body angular velocity signal for a particular Activity and Subject
35. fBodyBodyGyroJerkMag-mean = Mean of frequency domain Euclidean norm body angular velocity jerk signal for a particular Activity and Subject
36. tBodyAcc-std-X = Mean of standard deviations of time domain body acceleration signal along X Coordinate for a particular Activity and Subject
37. tBodyAcc-std-Y = Mean of standard deviations of time domain body acceleration signal along Y Coordinate for a particular Activity and Subject
38. tBodyAcc-std-Z = Mean of standard deviations of time domain body acceleration signal along Z Coordinate for a particular Activity and Subject
39. tGravityAcc-std-X = Mean of standard deviations of time domain gravity acceleration signal along X Coordinate for a particular Activity and Subject
40. tGravityAcc-std-Y = Mean of standard deviations of time domain gravity acceleration signal along Y Coordinate for a particular Activity and Subject
41. tGravityAcc-std-Z = Mean of standard deviations of time domain gravity acceleration signal along Z Coordinate for a particular Activity and Subject
42. tBodyAccJerk-std-X = Mean of standard deviations of time domain body acceleration jerk signal along X Coordinate for a particular Activity and Subject
43. tBodyAccJerk-std-Y = Mean of standard deviations of time domain body acceleration jerk signal along Y Coordinate for a particular Activity and Subject
44. tBodyAccJerk-std-Z = Mean of standard deviations of time domain body acceleration jerk signal along Z Coordinate for a particular Activity and Subject
45. tBodyGyro-std-X = Mean of standard deviations of time domain body angular velocity signal along X Coordinate for a particular Activity and Subject
46. tBodyGyro-std-Y = Mean of standard deviations of time domain body angular velocity signal along Y Coordinate for a particular Activity and Subject
47. tBodyGyro-std-Z = Mean of standard deviations of time domain body angular velocity signal along Z Coordinate for a particular Activity and Subject
48. tBodyGyroJerk-std-X = Mean of standard deviations of time domain body angular velocity jerk signal along X Coordinate for a particular Activity and Subject
49. tBodyGyroJerk-std-Y = Mean of standard deviations of time domain body angular velocity jerk signal along Y Coordinate for a particular Activity and Subject
50. tBodyGyroJerk-std-Z = Mean of standard deviations of time domain body angular velocity jerk signal along Z Coordinate for a particular Activity and Subject
51. tBodyAccMag-std = Mean of standard deviations of time domain Euclidean norm body acceleration signal for a particular Activity and Subject
52. tGravityAccMag-std = Mean of standard deviations of time domain Euclidean norm gravity acceleration signal for a particular Activity and Subject
53. tBodyAccJerkMag-std = Mean of standard deviations of time domain Euclidean norm body acceleration jerk signal for a particular Activity and Subject
54. tBodyGyroMag-std = Mean of standard deviations of time domain Euclidean norm body angular velocity signal for a particular Activity and Subject
55. tBodyGyroJerkMag-std = Mean of standard deviations of time domain Euclidean norm body angular velocity jerk signal for a particular Activity and Subject
56. fBodyAcc-std-X = Mean of standard deviations of frequency domain body acceleration signal along X Coordinate for a particular Activity and Subject
57. fBodyAcc-std-Y = Mean of standard deviations of frequency domain body acceleration signal along Y Coordinate for a particular Activity and Subject
58. fBodyAcc-std-Z = Mean of standard deviations of frequency domain body acceleration signal along Z Coordinate for a particular Activity and Subject
59. fBodyAccJerk-std-X = Mean of standard deviations of frequency domain body acceleration jerk signal along X Coordinate for a particular Activity and Subject
60. fBodyAccJerk-std-Y = Mean of standard deviations of frequency domain body acceleration jerk signal along Y Coordinate for a particular Activity and Subject
61. fBodyAccJerk-std-Z = Mean of standard deviations of frequency domain body acceleration jerk signal along Z Coordinate for a particular Activity and Subject
62. fBodyGyro-std-X = Mean of standard deviations of frequency domain body angular velocity signal along X Coordinate for a particular Activity and Subject
63. fBodyGyro-std-Y = Mean of standard deviations of frequency domain body angular velocity signal along Y Coordinate for a particular Activity and Subject
64. fBodyGyro-std-Z = Mean of standard deviations of frequency domain body angular velocity signal along Z Coordinate for a particular Activity and Subject
65. fBodyAccMag-std = Mean of standard deviations of frequency domain Euclidean norm body acceleration signal for a particular Activity and Subject
66. fBodyBodyAccJerkMag-std = Mean of standard deviations of frequency domain Euclidean norm body acceleration jerk signal for a particular Activity and Subject
67. fBodyBodyGyroMag-std = Mean of standard deviations of frequency domain Euclidean norm body angular velocity signal for a particular Activity and Subject
68. fBodyBodyGyroJerkMag-std = Mean of standard deviations of frequency domain Euclidean norm body angular velocity jerk signal for a particular Activity and Subject